C      25 ,    100      ,0
NO textures/wl1.xpm
EA textures/fb2.xpm
WE textures/fb3.xpm
F 230 ,100, 52   
SO ./textures/fb1.xpm

         1111111111111111111111111
         1000000000110000000000001
         1011000001110000000000001
         1001000000000000000000001
1111111111011000001110000000000001
11111011111111111111111111111111111
                
111111111111111111111
100000000011000001110111111111111111111
111101111111111011100000010001
11110111111111011101010010011
11000000110101011100000010001
1000000000000000110000100011
10000000000000001101010010001
11000001110101011111011110N0111
11110111 1110101 101111010001
11111111 1111111 111111111111