NO ./textures/wl1.xpm
SO ./textures/fb1.xpm
EA ./textures/fb2.xpm
WE ./textures/fb3.xpm
F     110,111,156
C 105,111,155

       1111111111111111111111111111111
        100000000E000000000000011111
        1011000010001100000000001111
        1001000011111000000000001
111111111011000001110000000000001
100000000011000001110111111111111
11110111111111011100000010001     1111111
11110111111111011101010010001       111111111
111111111011010101110000010001          111
10000000000000001100001000011               
10000000000000001101010010001                
100000011101010111110111100111
1001001101110101 101111010001
1001001111111111 111111111111
10010011111
10010000001
11010000011
11111111011
1111111101111111111111
       100000000001111111                                 111111
       10000000001111                                    11010111111111
       11111111001111111111111111                       11000000000001
       111111111000000000000000011111111111111111111111111010010010011
               1101000001000001000000000000000000000000000000000000001
                100000000000000011111111111111111001111111111111011111
                10001000100010001               1001           101
                10000000000000001               1001           101111111111111111
                10101010001010101               1001           100000000000000001
                10000000000000001           111110011111       111111111111111101
                10001000100100001           100000000001                      101                
                10000000000000001           100000000001                      101
                10100000100001001111111111111000100100011111111111111111111111101
                10000000000000000000000000000000000000000000000000000000000000001
                11111011111111111111111111111000100100011111111111111111111111101
                    101                     100000000001                      101
                11111011111111111           100000000001                      101
                10000000000000001           111110011111                      101
                10100000100000101               1001                          101
                10000000000000001111111111111111100111111111111111111111111111101
                10001000100010000000000000000000000000000000000000000000000000001
                10000000000000001111111111111111111111111111111111111111111111111
                10101010001010101
                10000000000000001                                                                   
                10001000100100001                                                                  
                10000000000000001                                                                 
                10100000100001001111111111111
                10000000000000000000000000001
                11111111111111111111111111111