

NO          ./textures/wl1.xpm
SO ./textures/fb1.xpm
EA ./textures/fb2.xpm
WE ./textures/fb3.xpm


F    195,255,35
C 125,120,25


11111111111111111111111111111111111111111111111111111
11000000000000000000000000000110000000000000000000011
110001E0000000000000000000000001100000000000000000011
11000000000000000000000000000110000000000000000000011
11000000000000000000000000000110000000000000000000011
11000001000000000000000000000011000000000100000000011
11000000000000000000000000000110000000000000000000011
11000000000000000000000000000110000000000000000000011
11111111111111111111111111111111111111111111111111111
