

NO          ./textures/wl1.xpm
SO ./textures/fb1.xpm
EA ./textures/fb2.xpm
WE ./textures/fb3.xpm


F    195,255,35
C 125,120,25


11111111111111111111111111111111111111111111111111111
10000000000000000000000000000110000000000000000000001
100001E00000000000000000000000011000000000000000000001
10000000000000000000000000000110000000000000000000001
10000000000000000000000000000110000000000000000000001
10000001000000000000000000000011000000000100000000001
10000000000000000000000000000110000000000000000000001
10000000000000000000000000000110000000000000000000001
11111111111111111111111111111111111111111111111111111
