NO texture/no.xpm
SO texture/so.xpm
WE texture/we.xpm
EA texture/ea.xpm

F 220    , 100  ,  1  
     C   225,30,2   

       11111111111111111111111111111
        100000000110000000000011111
        1011000001110000000000001111
        100100000000000000000001
111111111011000001110000000000001
100000000011000001110111111111111
1111011111111101110000001000111
1111011111111101110W0010010001
111111111011010101110000010001
10000000000000001100001000011
111111111111111111111111111
          
111111111111111111111111111
110000011101010111110111100111
11110111 1110101 101111010001
11111111 1111111 111111111111
11111111111
100100000001
11010000011
11111111111 
     
11111111111111